25 20





        #########
        #..@....#
        #.......#
        #.......#
        #.......#
        #N.....Q#
        #.......#
        #########











